#...##.....
..##.....##
.#.@..##..#
##...#..#..
#....###..#
###...##...
.##..##...#
.##.....###
........###
..#....##..
...#..##...