####.......
..##.....##
.##...##...
##...##...#
###.......#
.....####..
..#..##....
.#...#..###
#.@.....###
..#....##..
...#..##...
....#...##.